1111111111111111111
1E00C0000000000C001
1010010100100000101
1010010010101010001
100000000C00C000001
1111111111111111111
